ighoulsa, станция Beta - черная дыра 
Aethan-Pam XVII - древние кости, крутой мультитул, 1460 урона, 1 230 000, 15 ячеек 
Meleiber - галактика с черной дырой 
Jibour - обычная галактика, крутой мультитул 1370 урона,1 865 000, 19 ячеек 
Tusiisko XIII - морозные кристаллы, база Ne otmoroz zhopu 
Clyidianu - соль, уран, база Konskiy chlen 
Yannacup VII - соланий, фосфор, древние кости, много опасной флоры и камней знаний на Jonathac Meric 
Shuanthon XII - планета с неизбежной детонацией ядра, очень красивая ледяная планета с деревьями 
Vaiutsim - морозные кристаллы, соль
Itwork-Mima - галактика с кадмием и пиратами, мультитул s класса 12 ячеек
Naningto - галактика без станции тп
Onarin-Wazaw - сигнал бедствия, получен имперский шаттл, средние планеты
Izberb-Thsea VI - эмериловая галактика, безжизненные планеты, пираты
Richuv малый - болотная планета, в общем - 2 планеты, эмерил, без станции
Turlov-Osa - заброшенная станция, эмерил, арктическая планета
Omplim - индий
Liybrit-Priap - индий, 2 планеты, 1 заросшая с стражами и забивными живатными
Oevushc-Jujie - пираты, arvik V - огромная мракобесящая тварь, ветреная планета
Helenta-Osonq - интерфейс атласа 1, покрытая травой планета
Buynak-Huha - высокорадиационная планета, связной апполона
Vokulo IX - зеленая планета без стражей
Penzan - щелочная планета, вулканическая планета, инженер
Auchies-Aho - обезжизненная станция, бесконечная топь
Oezeth X - планета с собираемым ломом, изобильная планета
Onvillo - много собираемого лома, зеленая планета с повышенной активностью стражей
Lecart-Kitn - планета дожди 
Finardeng - пыльная планета, зеленая планета без стражей!!!
Kahunauz - споровая планета, планета с 	ами (агрессивные стражи), умеренная планета (повышеннаыя активность стражей), очень красивый острова для дачи, черная дыра, пропавшая, хорошая экономика
Jajalal - призрачная планета с эмерилом, планета с низкой атмосферой, расколотая планета, мультитул А класса
Oguang-Mino - Кипящая планетаъ
Gulung VII - райская планета!!!, споровая планета, неясная планета
Ebayusu-Vosk - система из чертова портала
Esakao-Ziniki - облачная планета, S класс мультитула, сам гавно,